            +--------------------------+---------+
            |                         /       C  |
            |           (bedroom)    /           |
            |                       /            |
+----------+     W                 /   (toilet)  |
|           \                     /              |
|      C     \                   /               |
|           +-+-----------------+----------------+
|           |    W                       S       |
| (closet)  |                                    |
| P    P    |          (sleeping room)           |
+-----------+------------------------------------+
